14 10
768 448
7 6 7 7 7 7 7 7 7 7 7 7 7 7
7 1 7 7 7 7 7 7 7 7 7 1 7 7
7 1 7 7 7 7 7 7 7 7 7 1 7 7
7 1 7 7 7 7 7 7 7 7 7 1 7 7
7 1 7 7 7 7 7 7 7 7 7 1 7 7
7 1 7 7 7 7 6 7 7 7 7 1 7 7
7 1 7 7 7 7 1 7 7 7 7 1 7 7
7 1 1 1 1 1 1 1 1 1 1 1 1 6
7 6 7 7 7 7 1 7 7 7 7 1 6 7
7 7 7 7 7 7 6 7 7 7 7 7 7 7