30 27
1152 1536
2 2 2 2 2 2 2 2 2 2 2 2 2 2 2 2 2 2 2 2 2 2 2 2 2 2 2 2 2 2
2 2 2 0 0 0 0 0 0 0 0 0 0 5 5 5 5 0 1 1 5 5 5 5 0 5 5 5 5 2
2 1 1 0 0 5 5 5 5 0 0 0 0 5 5 5 5 0 1 1 5 5 5 5 0 5 5 5 5 2
2 1 1 0 0 5 5 5 5 0 0 0 0 5 5 5 5 0 1 1 5 5 5 5 0 5 5 5 5 2
2 1 1 0 0 5 5 5 5 0 0 0 0 5 5 5 5 0 1 1 1 1 1 1 1 1 1 1 1 2
2 1 1 0 0 0 0 0 0 0 0 0 0 0 0 0 0 0 1 1 1 1 1 1 1 1 1 1 1 2
2 1 1 0 0 0 0 0 0 0 0 0 0 0 0 0 0 0 1 1 1 1 1 1 1 1 1 1 1 2
2 1 1 0 0 0 0 0 0 0 0 0 0 0 0 0 0 0 1 1 1 1 1 1 1 1 1 1 1 2
2 1 1 0 0 0 0 0 0 0 0 0 0 0 0 0 0 0 1 1 1 1 1 1 1 1 1 1 2 2
2 1 1 0 0 0 0 0 0 0 0 0 0 0 0 0 0 0 1 1 5 5 5 3 3 3 3 3 2 2
2 1 1 0 0 0 0 0 0 0 0 0 0 0 0 0 0 0 1 1 5 5 5 3 3 3 3 3 2 2
2 1 1 0 0 0 0 0 0 0 0 0 0 0 0 0 0 0 1 1 5 5 5 3 3 3 3 3 2 2
2 1 1 1 1 1 1 1 1 1 1 1 1 1 1 1 1 1 1 1 0 0 0 0 0 0 0 0 0 2
2 1 1 1 1 1 6 1 1 1 1 1 1 1 6 6 1 1 1 1 0 0 0 0 0 0 0 0 0 2
2 1 1 4 4 4 4 4 4 4 4 4 4 4 4 4 4 4 1 1 0 0 0 0 0 0 0 0 0 2
2 1 1 4 4 4 4 4 4 4 4 4 4 4 4 4 4 4 1 1 0 0 0 1 1 1 1 0 0 2
2 1 1 4 4 4 4 4 4 4 4 4 4 4 4 4 4 6 1 1 1 1 1 1 1 1 1 1 6 2
2 1 1 4 4 4 4 4 4 4 4 4 4 4 4 4 4 6 1 1 1 1 1 1 1 1 1 1 6 2
2 1 1 4 4 4 4 4 4 4 4 4 4 4 4 4 4 4 1 1 0 0 0 1 1 1 1 0 0 2
2 1 1 4 4 4 4 4 4 4 4 4 4 4 4 4 4 4 1 1 0 0 0 0 0 0 0 0 0 2
2 1 1 1 1 1 1 1 6 6 6 1 1 1 1 1 1 1 1 1 0 0 0 0 0 0 0 0 0 2
2 1 1 1 1 1 1 1 1 1 1 1 1 1 1 1 1 1 1 1 0 0 0 0 0 0 0 0 0 2
2 1 1 0 0 0 0 0 0 0 0 0 0 0 0 0 0 0 1 1 0 0 0 0 0 0 0 0 0 2
2 1 1 0 0 0 0 0 0 0 0 0 0 0 0 0 0 0 1 1 0 0 0 0 0 0 0 0 0 2
2 1 1 0 0 0 0 0 0 0 0 0 0 0 0 0 0 0 1 1 0 0 0 0 0 0 0 0 0 2
2 1 1 0 0 0 0 0 0 0 0 0 0 0 0 0 0 0 1 1 1 1 1 1 1 1 1 1 1 2
2 2 2 2 2 2 2 2 2 2 2 2 2 2 2 2 2 2 2 2 2 2 2 2 2 2 2 2 2 2